AKxx,Qxx,AJxxx,J
AKxxx,Qxx,AJxx,J
Axx,Qxx,Axxx,Jxx
Axxx,Qxx,Jxxx,Jx
KQxxx,AKxxx,J,xx
AKxx,xxx,xxx,AKx
AKxx,AKxxx,x,AKx
KJxx,Kxxx,QJ,QJx
AKxxx,Qxxxx,xx,A
AKxx,xxx,xxx,Axx